TileSet.png
100,60,16
2082,2083,2236,2237,2182,2282,2283,2284,2232,2131,2132,2085,2135,2185,2235,2227,2230,2277,2278,2279,2280,152,303,304,305,358,405,406,407,408,353,354,355,153,203,253,154,155,104,105,55,56,57,58,108,109,158,159,160,210,260,308,309,310,2336,2337,2386,2387,300,301,350,351,2278,2279,2285,834,835,884,885,934,935,984,985,1034,1035,1772,837,836,886,936,986,1036,1087,1088,1089,1090,1091,1041,991,941,891,841,840,1809,1810,1811,1812,1813,1814,1859,1860,1861,1862,1863,1864,1909,1910,1911,1912,1913,1914,1959,1960,1961,1962,1963,1964,2009,2010,2011,2012,2013,2014,2059,2060,2061,2062,2063,2064,436,437,486,487,536,537,586,587
2077,2078,2079,2080,2127,2128,2129,2130,2177,2178,2179,2180,2228,2229,2183,2184,2233,1246,1247,1296,1297,1346,1347,1396,1398,1446,1447,1491,1441,1391,1392,1393,1394,1444,1494,13411342,1343,1344,1291,1292,1293,1294,1241,1242,1243,1244,1191,1192,1193,1194,1142,1143,898,899,948,949,998,999,1048,1049,1098,1099,848,1184,1185,1186,1187,1188,1189,1234,1235,1236,1237,1238,1239,1284,1285,1286,1287,1288,1289,1334,1339,1384,1389,1497,1498,1546,1547,1548,1596,1597,1598,1647,1648
3,3,87,50
27,29,90,50
834,835,834,835,834,835,834,835,834,835,834,835,834,835,834,835,834,835,834,835,834,835,834,835,834,835,834,835,834,835,834,835,834,835,834,835,834,835,834,835,834,835,834,835,834,835,834,835,834,835,834,835,834,835,834,835,834,835,834,835,834,835,834,835,834,835,834,835,834,835,834,835,834,835,834,835,834,835,834,835,834,835,834,835,834,835,834,835,834,835,834,835,834,835,834,835,834,835,834,835
884,885,884,885,884,885,884,885,884,885,884,885,884,885,884,885,884,885,884,885,884,885,884,885,884,885,884,885,884,885,884,885,884,885,884,885,884,885,884,885,884,885,884,885,884,885,884,885,884,885,884,885,884,885,884,885,884,885,884,885,884,885,884,885,884,885,884,885,884,885,884,885,884,885,884,885,884,885,884,885,884,885,884,885,884,885,884,885,884,885,884,885,884,885,884,885,884,885,884,885
834,835,834,835,834,835,834,835,834,835,834,835,834,835,834,835,834,835,834,835,834,835,834,835,834,835,834,835,834,835,834,835,834,835,834,835,834,835,834,835,834,835,834,835,834,835,834,835,834,835,834,835,834,835,834,835,834,835,834,835,834,835,834,835,834,835,834,835,834,835,834,835,834,835,834,835,834,835,834,835,834,835,834,835,834,835,834,835,834,835,834,835,834,835,834,835,834,835,834,835
884,885,884,885,884,885,884,885,884,885,884,885,884,885,884,885,884,885,884,885,884,885,884,885,884,885,884,885,884,885,884,885,884,885,884,885,884,885,884,885,884,885,884,885,884,885,884,885,884,885,884,885,884,885,884,885,884,885,884,885,884,885,884,885,884,885,884,885,884,885,884,885,884,885,884,885,884,885,884,885,884,885,884,885,884,885,884,885,884,885,884,885,884,885,884,885,884,885,884,885
834,835,834,835,834,835,834,835,834,835,834,835,834,835,834,835,834,835,834,835,834,835,834,835,834,835,834,835,834,835,834,835,834,835,834,835,834,835,834,835,834,835,834,835,834,835,834,835,834,835,834,835,834,835,834,835,834,835,834,835,834,835,834,835,834,835,834,835,834,835,834,835,834,835,834,835,834,835,834,835,834,835,834,835,834,835,834,835,834,835,834,835,834,835,834,835,834,835,834,835
1772,1772,1772,1772,1772,1772,1772,1772,1772,1772,1772,1772,1772,1772,1772,1772,1772,1772,1772,1772,1772,1772,1772,1772,884,885,884,885,884,885,884,885,884,885,884,885,884,885,884,885,884,885,884,885,884,885,884,885,884,836,837,838,838,838,838,838,838,838,838,838,838,838,838,838,838,838,838,838,838,838,838,839,838,839,838,838,838,838,838,838,838,838,838,838,838,838,838,838,838,838,838,838,838,838,838,838,838,838,838,838
1772,1772,1772,1772,1772,1772,1772,1772,1772,1772,1772,1772,1772,1772,1772,1772,1772,1772,1772,1772,1772,1772,1772,1772,834,835,834,835,834,835,834,835,834,835,834,835,834,835,834,835,834,835,834,835,834,835,834,835,834,886,887,939,988,989,1038,1038,1038,1038,1038,1038,1038,1038,1038,1038,1038,1038,1038,1038,1038,1038,1038,1038,1038,1038,1038,1038,1038,1038,1038,1038,1038,1038,1038,1038,1038,1038,1038,1038,1038,1038,1038,1038,1038,1038,1038,1038,1038,1038,1038,1038
884,885,884,885,884,885,884,885,884,885,884,885,884,885,884,885,884,885,884,885,884,885,1772,1772,884,885,884,885,884,885,884,885,884,885,884,885,884,885,884,885,884,885,884,885,884,885,884,885,884,936,937,938,990,991,884,885,884,885,884,885,884,885,884,885,884,885,884,885,884,885,884,885,884,885,884,885,884,885,884,885,884,885,884,885,884,885,884,885,884,885,884,885,884,885,884,885,884,885,884,885
834,835,834,835,834,835,834,835,834,835,834,835,834,835,834,835,834,835,834,835,834,835,1772,1772,834,835,834,835,834,835,834,835,834,835,834,835,834,835,834,835,834,835,834,835,834,835,834,835,834,936,937,938,1040,1041,834,835,834,835,834,835,834,835,834,835,834,835,834,835,834,835,834,835,834,835,834,835,834,835,834,835,834,835,834,835,834,835,834,835,834,835,834,835,834,835,834,835,834,835,834,835
884,885,884,885,884,885,884,885,884,885,884,885,884,885,884,885,884,885,884,885,884,885,1772,1772,884,885,884,885,884,885,884,885,884,885,884,885,884,885,884,885,884,885,884,885,884,885,884,885,884,936,937,990,991,885,884,885,884,885,884,885,884,885,884,885,884,885,884,885,884,885,884,885,884,885,884,885,884,885,884,885,884,885,884,834,835,885,884,885,884,885,884,885,884,885,884,885,884,885,884,885
834,835,834,835,834,835,834,835,834,835,834,835,834,835,834,835,834,835,834,835,834,835,1772,1772,834,835,834,835,834,835,834,835,834,835,834,835,834,835,834,835,834,835,834,835,834,835,834,835,834,936,937,990,991,835,834,835,834,835,834,835,834,835,834,835,834,835,834,835,834,835,834,835,834,835,834,835,834,835,834,835,834,834,835,834,835,835,834,835,834,835,834,835,834,835,834,835,834,835,834,835
884,885,884,885,884,885,884,885,884,885,1809,1810,1811,1811,1811,1812,1812,1812,1812,1812,1812,1812,1812,1812,1812,1811,1811,1811,1811,1811,1811,1811,1811,1811,1811,1811,1811,1813,1813,1814,884,885,884,885,884,885,884,885,884,936,937,940,941,885,884,885,884,885,884,885,884,885,884,885,884,885,884,885,884,885,884,885,884,885,884,834,835,834,834,834,834,834,834,835,835,885,834,835,884,885,884,885,884,885,884,885,884,885,884,885
834,835,834,835,834,835,834,835,834,835,1859,1911,1912,1911,1912,1911,1912,1911,1912,1911,1912,1911,1912,1911,1912,1911,1912,1911,1912,1911,1912,1911,1912,1911,1912,1911,1912,1911,1912,1864,834,835,834,835,834,835,834,835,834,936,937,990,991,835,834,835,834,835,834,835,834,835,834,835,834,835,834,835,834,835,834,835,834,835,834,848,849,835,834,834,834,834,1196,1197,835,835,884,885,834,848,849,835,834,835,834,835,834,835,834,835
884,885,884,885,884,885,884,885,884,885,1909,1961,1962,1961,1962,1961,1962,1961,1962,1961,1962,1961,1962,1961,1962,1961,1962,1961,1962,1961,1962,300,301,1961,1962,1961,1962,1961,1962,1864,884,885,884,885,884,885,884,885,884,936,937,939,891,885,884,885,884,885,884,885,884,885,884,885,884,885,884,885,884,885,884,885,884,885,884,898,899,885,884,834,835,834,1246,1247,834,835,834,835,884,898,899,885,884,885,884,885,884,885,884,885
834,835,834,835,834,835,834,835,834,835,1909,1911,1912,1911,1912,1911,1912,1911,1912,1911,1912,1911,1912,1911,1912,1911,1912,1911,2082,2083,2084,2085,351,1911,1912,1911,1912,1911,1962,1964,834,835,834,835,834,835,834,835,834,936,937,940,941,835,834,835,834,835,934,935,934,935,934,935,934,935,934,935,934,935,934,935,934,935,934,948,949,935,834,835,835,834,1296,1297,834,835,834,835,934,948,949,935,934,935,834,835,834,835,834,835
884,885,884,885,884,885,884,885,884,885,1909,1961,1962,1961,1962,1961,55,56,57,58,1962,1961,1962,1961,1962,1961,1962,1961,2132,2133,2134,2135,1962,1961,300,301,1962,1961,1962,1964,934,935,934,935,934,935,934,935,934,936,937,990,991,885,884,885,884,885,934,935,934,935,934,935,934,935,934,935,934,935,934,935,934,935,934,998,999,935,834,835,835,834,1346,1347,834,835,834,835,934,998,999,935,934,935,884,885,884,885,884,885
834,835,834,835,834,835,834,835,834,835,1909,1911,1912,300,301,1911,105,106,107,108,1912,1911,1912,1911,1912,1911,1912,1911,2182,2183,2184,2185,1912,1911,350,351,1912,1911,1962,1964,934,935,934,935,934,935,934,935,934,936,937,940,941,934,935,934,935,934,935,934,935,934,935,934,935,935,934,935,934,935,934,935,934,935,934,1048,1049,935,834,835,834,834,1396,1397,835,835,834,835,835,1048,1049,935,934,935,834,835,834,835,834,835
884,885,884,885,884,885,884,885,884,885,1909,1961,1962,350,153,154,155,156,157,158,159,160,1962,300,301,1961,2336,2337,2232,2233,2234,2235,1962,1961,1962,1961,1962,1961,1962,1964,934,935,934,935,934,935,934,935,934,936,937,990,991,934,935,934,935,934,935,934,935,934,935,934,935,935,934,935,934,935,934,935,934,935,934,1098,1099,935,834,835,834,834,1446,1447,885,835,834,835,885,1098,1099,935,934,935,884,885,884,885,884,885
834,835,834,835,834,835,834,835,834,835,1909,1911,1912,1911,203,204,205,206,207,208,209,210,1912,350,351,1911,2386,2387,2282,2283,2284,2285,1912,1911,1912,1911,1912,1911,1962,1964,934,935,934,935,934,935,934,935,934,936,937,940,941,934,935,934,935,934,935,934,935,934,935,934,935,935,934,935,934,935,934,935,934,935,934,848,849,935,934,935,834,834,835,884,885,835,834,835,835,848,849,935,934,935,834,835,834,835,834,835
884,885,884,885,884,885,884,885,884,885,1909,1961,1962,1961,253,254,255,256,257,258,259,260,1962,1961,1962,1961,1962,1961,1962,1961,1962,1961,1962,1961,1962,1961,300,301,1962,1964,934,935,934,935,934,935,934,935,934,936,937,990,991,934,935,934,935,934,935,934,935,934,935,934,935,935,934,935,934,935,934,935,934,935,934,898,899,935,934,935,834,884,885,884,885,835,834,835,885,898,899,935,934,935,884,885,884,885,884,885
834,835,834,835,834,835,834,835,834,835,1909,1911,1912,1911,303,304,305,306,307,308,309,310,1912,1911,1912,1911,1912,1911,1912,1911,1912,1911,1912,1911,1912,1911,350,351,1912,1964,934,935,934,935,934,935,934,935,934,936,937,940,941,934,935,934,935,934,935,934,935,934,935,934,935,935,934,935,934,935,934,935,934,935,934,948,949,935,934,935,834,835,934,935,884,885,834,835,835,948,949,935,934,935,834,835,834,835,834,835
884,885,884,885,884,885,884,885,884,885,1909,1961,1962,1961,1962,152,355,356,357,358,1962,1961,1962,1961,1962,1961,1962,1961,1962,1961,1962,1961,1962,1961,1962,1961,1962,1961,1962,1964,934,935,934,935,934,935,934,935,934,936,937,990,991,934,935,934,935,934,935,934,935,934,935,934,935,935,934,935,934,935,934,935,934,935,934,998,999,935,934,935,834,835,934,935,884,885,834,835,885,998,999,935,934,935,884,885,884,885,884,885
834,835,834,835,834,835,834,835,834,835,1909,1911,1912,1911,1912,152,405,406,407,408,1912,1911,1912,1911,1912,1911,1912,1911,1912,1911,1912,1911,1912,1911,1912,1911,1912,1911,1912,1964,834,835,834,835,834,835,834,835,834,936,937,939,891,934,935,934,935,934,935,934,935,934,935,934,935,935,934,935,934,935,934,935,934,935,934,1048,1049,935,934,935,934,935,934,935,934,884,834,835,835,1048,1049,935,934,935,834,835,834,835,834,835
884,885,884,885,884,885,884,885,884,885,1909,1961,1962,300,301,1961,1962,1961,1962,1961,1962,1961,1962,1961,1962,1961,1962,1961,1962,1961,1962,1961,1962,1961,1962,1961,1962,1961,1962,1964,884,885,884,885,884,885,884,885,884,936,937,940,941,934,935,934,935,934,935,934,935,934,935,934,935,935,934,935,934,935,934,935,934,935,934,1098,1099,935,934,935,934,935,934,935,934,884,834,835,934,1098,1099,935,934,935,884,885,884,885,884,885
834,835,834,835,834,835,834,835,834,835,1909,1911,1912,350,351,1911,1912,1911,1912,1911,1912,1911,1912,1911,300,301,1912,1911,1912,1911,1912,1911,300,301,1912,1911,1912,1911,1912,1964,834,835,834,835,834,835,834,835,834,936,937,990,991,934,935,934,935,934,935,934,935,934,935,934,935,935,934,935,934,935,934,935,934,935,934,848,849,935,934,935,934,935,934,935,934,884,834,835,934,848,849,935,934,935,834,835,834,835,834,835
884,885,884,885,884,885,884,885,884,885,1909,1962,1962,1961,1962,1961,1962,1961,1962,1961,1962,1961,1962,1961,350,351,1962,1961,1962,1961,1962,1961,350,351,1962,1961,1962,1961,1962,1964,884,885,884,885,884,885,884,885,884,936,937,939,891,934,935,934,935,934,935,934,935,934,935,934,935,935,934,935,934,935,934,935,934,935,934,898,899,935,934,935,934,935,934,935,934,935,834,835,934,898,899,935,934,935,884,885,884,885,884,885
834,835,834,835,834,835,834,835,834,835,1909,1962,1962,1962,1912,1911,1912,1911,1912,1911,1912,1911,1912,1911,1912,1911,1912,1911,1912,1911,1912,1911,1912,1911,1912,1911,1912,1911,1912,1964,834,835,834,835,834,835,834,835,834,936,937,940,941,934,935,934,935,934,935,934,935,934,935,934,935,935,934,935,934,935,934,935,934,935,934,948,949,935,934,935,934,935,934,935,934,935,834,835,934,948,949,935,934,935,834,835,834,835,834,835
884,885,884,885,884,885,884,885,884,885,1909,300,301,2077,2078,2079,2080,1961,1962,1961,1962,1961,1962,1961,1962,1961,1962,1961,1962,1961,1962,1961,1962,1961,1962,1961,1962,1961,1962,1964,884,885,884,885,884,885,884,885,884,936,937,990,991,885,884,885,884,885,934,935,934,935,934,935,934,935,934,935,934,935,934,935,934,935,934,998,999,935,934,935,934,935,934,935,934,935,834,835,934,998,999,935,934,935,884,885,884,885,884,885
834,835,834,835,834,835,834,835,834,835,1909,350,351,2127,2128,2129,2130,301,1912,1911,1912,1911,1912,1911,1912,1911,1912,1911,1912,1911,1912,1911,1912,1911,1912,1911,1912,1911,1912,1964,834,835,834,835,834,835,834,835,834,936,937,939,891,835,834,835,834,835,934,935,934,935,934,935,934,935,934,935,934,935,934,935,934,935,934,1048,1049,935,934,935,934,935,934,935,934,935,834,835,934,1048,1049,935,934,935,834,835,834,835,834,835
884,885,884,885,884,885,884,885,884,885,1909,1962,1962,2177,2178,2179,2180,300,301,1961,1962,1961,1962,1961,1962,1961,1962,1961,1962,1961,1962,1961,1962,1961,1962,1961,1962,1961,1962,1964,884,885,884,885,884,885,884,885,884,936,937,940,941,885,884,885,884,885,934,935,934,935,934,935,934,935,934,935,934,935,934,935,934,935,934,1098,1099,935,934,935,934,935,934,935,934,935,834,835,934,1098,1099,935,934,935,884,885,884,885,884,885
834,835,834,835,834,835,834,835,834,835,1909,1962,1912,2227,2228,2229,2230,350,351,1911,1912,1911,1912,1911,1912,1911,1912,1911,1912,1911,1912,1911,1912,1911,1912,2077,2078,2079,2080,1964,834,835,834,835,834,835,834,835,834,936,937,990,991,835,834,835,834,835,934,935,934,935,934,935,934,935,934,935,934,935,934,935,934,935,934,935,934,935,934,935,934,935,934,935,934,935,884,885,934,935,934,935,934,935,834,835,834,835,834,835
884,885,884,885,884,885,884,885,884,885,1909,1961,1962,2277,2278,2279,2280,1961,1962,1961,1962,1961,1962,1961,1962,1961,1962,1961,1962,1961,1962,300,301,1961,1962,2127,2128,2129,2130,1964,884,885,884,885,884,885,884,885,884,936,937,939,891,885,884,885,884,885,934,935,934,935,934,935,934,935,934,935,934,935,934,935,934,935,934,935,934,935,934,935,934,935,934,935,934,935,934,935,934,935,934,935,934,935,884,885,884,885,884,885
834,835,834,835,834,835,834,835,834,835,1909,1911,1912,1911,1912,1911,1912,1911,1912,1911,1912,1911,1912,1911,1912,1911,1912,1911,1912,1911,1912,350,351,1911,1912,2177,2178,2179,2180,1964,834,835,834,835,834,835,834,835,834,936,937,940,941,835,834,835,834,835,934,935,934,935,934,935,934,935,934,935,934,935,934,935,934,935,934,935,934,935,934,935,934,935,934,935,934,935,934,935,934,935,934,935,934,935,834,835,834,835,834,835
884,885,884,885,884,885,884,885,884,885,1909,1961,1962,1961,1962,1961,1962,1961,1962,1961,1962,1961,1962,1961,1962,1961,1962,1961,1962,1961,1962,1961,1962,1961,1962,2227,2228,2229,2230,1964,884,885,884,885,884,885,884,885,884,936,937,990,991,885,884,885,884,885,934,935,934,935,934,935,934,935,934,935,934,935,934,935,934,935,934,935,934,935,934,935,934,935,934,935,934,935,934,935,934,935,934,935,934,935,884,885,884,885,884,885
834,835,834,835,834,835,834,835,834,835,2009,1911,1912,1911,1912,1911,1912,1911,1912,1911,1912,1911,1912,1911,1912,1911,1912,1911,1912,1911,1912,1911,1912,1911,1912,2277,2278,2279,2280,2014,834,835,834,835,834,835,834,835,834,936,937,940,941,835,834,835,834,835,934,935,934,935,934,935,934,935,934,935,934,935,934,935,934,935,934,935,934,935,934,935,934,935,934,935,934,935,934,935,934,935,934,935,934,935,834,835,834,835,834,835
884,885,884,885,884,885,884,885,884,885,2059,2060,2060,2060,2060,2060,2060,2061,2061,2061,2061,2061,2061,2061,2061,2061,2061,2061,2061,2061,2061,2061,2061,2061,2061,2061,2062,2062,2063,2064,884,885,884,885,884,885,884,885,884,936,937,990,991,885,884,885,884,885,934,935,934,935,934,935,934,935,934,935,934,935,934,935,934,935,934,935,934,935,934,935,934,935,934,935,934,935,934,935,934,935,934,935,934,935,884,885,884,885,884,885
834,835,834,835,834,835,834,835,834,835,834,835,834,835,834,835,834,835,834,835,834,835,1772,1772,834,835,834,835,834,835,834,835,834,835,834,835,834,835,834,835,834,835,834,835,834,835,834,835,834,936,937,939,891,835,834,835,834,835,934,935,934,935,934,935,934,935,934,935,934,935,934,935,934,935,934,935,934,935,934,935,934,935,934,935,934,935,934,935,934,935,934,935,934,935,834,835,834,835,834,835
884,885,884,885,884,885,884,885,884,885,884,885,884,885,884,885,884,885,884,885,884,885,1772,1772,884,885,884,885,884,885,884,885,884,885,884,885,884,885,884,885,884,885,884,885,884,885,884,885,884,936,937,940,941,885,884,885,884,885,934,935,934,935,934,935,934,935,934,935,934,935,934,935,934,935,934,935,934,935,934,935,934,935,934,935,934,935,934,935,934,935,934,935,934,935,884,885,884,885,884,885
834,835,834,835,834,835,834,835,834,835,834,835,834,835,834,835,834,835,834,835,834,835,1772,1772,834,835,834,835,834,835,834,835,834,835,834,835,834,835,834,835,834,835,834,835,834,835,834,835,834,936,937,990,991,835,834,835,834,835,834,835,834,835,834,835,834,835,834,835,834,835,834,835,834,835,834,835,834,835,834,835,834,835,834,835,834,835,834,835,834,835,834,835,834,835,834,835,834,835,834,835
884,885,884,885,884,885,884,885,884,885,884,885,884,885,884,885,884,885,884,885,884,885,1772,1772,884,885,884,885,884,885,884,885,884,885,884,885,884,885,884,885,884,885,884,885,884,885,884,885,884,936,937,939,891,885,884,885,884,885,884,885,884,885,884,885,884,885,884,885,884,885,884,885,884,885,884,885,884,885,884,885,884,885,834,834,835,834,835,834,835,834,835,885,884,885,884,885,884,885,884,885
834,835,834,835,834,835,834,835,834,835,834,835,834,835,834,835,834,835,834,835,834,835,1772,1772,834,835,834,835,834,835,834,835,834,835,834,835,834,835,834,835,834,835,834,835,834,835,834,835,834,936,937,940,941,835,834,835,834,835,834,835,834,835,834,835,834,835,834,835,834,835,834,835,834,835,834,835,834,835,834,835,834,835,834,834,835,834,835,834,835,834,835,835,834,835,834,835,834,835,834,835
884,885,884,885,884,885,884,885,884,885,884,885,884,885,884,885,884,885,884,885,884,885,1772,1772,1772,1772,1772,1772,1772,1772,1772,1772,1772,1772,1772,1772,1772,1772,1772,1772,884,885,884,885,884,885,884,885,884,936,937,990,991,885,884,885,884,885,884,885,884,885,884,885,884,885,884,885,884,885,884,885,884,885,884,885,884,885,884,1141,1142,1143,1144,834,835,834,835,834,835,834,835,885,884,885,884,885,884,885,884,885
834,835,834,835,834,835,834,835,834,835,834,835,834,835,834,835,834,835,834,835,834,835,1772,1772,1772,1772,1772,1772,1772,1772,1772,1772,1772,1772,1772,1772,1772,1772,1772,1772,834,835,834,835,834,835,834,835,834,936,937,939,891,835,834,835,834,835,834,835,834,835,834,835,834,835,834,1134,1135,1136,1137,1138,1139,1134,1135,1136,1137,1138,1139,1191,1192,1193,1194,834,835,834,835,834,835,834,835,835,834,835,834,835,834,835,834,835
884,885,884,885,884,885,884,885,884,885,884,885,884,885,884,885,884,885,884,885,884,885,884,885,884,885,884,885,884,885,884,885,884,885,884,885,884,885,1772,1772,884,885,884,885,884,885,884,885,884,986,938,940,941,885,884,885,884,885,884,885,884,885,884,885,884,885,884,1184,1185,1186,1187,1188,1189,1184,1185,1186,1187,1188,1189,1241,1242,1243,1244,834,835,834,835,834,835,834,835,885,884,885,884,885,884,885,884,885
834,835,834,835,834,835,834,835,834,835,834,835,834,835,834,835,834,835,834,835,834,835,834,835,834,835,834,835,834,835,834,835,834,835,834,835,834,835,1772,1772,834,835,834,835,834,835,834,835,834,936,988,990,991,835,834,835,834,835,834,835,834,835,834,835,834,835,834,1234,1235,1236,1237,1238,1239,1234,1235,1236,1237,1238,1239,1291,1292,1293,1294,834,835,834,835,834,835,834,835,835,834,835,834,835,834,835,834,835
884,885,884,885,884,885,884,885,884,885,884,885,884,885,884,885,884,885,884,885,884,885,884,885,884,885,884,885,884,885,884,885,884,885,884,885,884,885,1772,1772,884,885,884,885,884,885,884,885,884,837,938,939,991,885,884,885,884,885,884,885,884,885,884,885,884,885,884,1284,1285,1286,1287,1288,1289,1284,1285,1286,1287,1288,1289,1341,1342,1343,1344,834,835,834,835,834,835,834,835,885,884,885,884,885,884,885,884,885
834,835,834,835,834,835,834,835,834,835,834,835,834,835,834,835,834,835,837,838,838,838,838,838,838,838,838,838,838,838,838,838,838,838,838,838,838,436,437,436,437,838,838,838,838,838,838,838,838,939,988,989,891,835,834,835,834,835,834,835,834,835,834,835,834,835,834,1334,1335,1336,1337,1338,1339,1334,1335,1336,1337,1338,1339,1391,1392,1393,1394,834,835,834,835,834,835,834,835,835,834,835,834,835,834,835,834,835
884,885,884,885,884,885,884,885,884,885,884,885,884,885,884,885,884,885,887,938,939,888,889,938,939,938,939,938,939,938,939,938,939,938,939,938,938,486,487,486,487,939,938,939,938,939,938,939,938,939,938,940,941,885,884,885,884,885,884,885,884,885,884,885,884,885,884,1384,1385,1386,1387,1388,1389,1384,1385,1386,1387,1388,1389,1441,1442,1443,1444,834,835,834,835,834,835,834,835,885,884,885,884,885,884,885,884,885
834,835,834,835,834,835,834,835,834,835,834,835,834,835,834,835,834,986,938,939,989,938,939,988,989,988,989,988,989,988,989,988,989,988,989,988,988,536,537,536,537,989,988,989,988,989,988,989,988,989,988,989,991,835,834,835,834,835,834,835,834,835,834,835,834,835,834,835,1496,1497,1498,835,834,835,1772,1772,834,835,834,1491,1492,1493,1494,834,835,834,835,834,835,834,835,835,834,835,834,835,834,835,834,835
884,885,884,885,884,885,884,885,884,885,884,885,884,885,884,885,884,986,938,939,989,938,939,990,1038,1038,1038,1038,1038,1038,1038,1038,1038,1038,1038,1038,1038,586,587,586,587,1038,1038,1038,1038,1038,1038,1038,1038,1038,1038,1040,884,885,884,885,884,885,884,885,884,885,884,885,884,885,884,885,1546,1547,1548,885,884,885,1772,1772,884,885,884,885,884,885,884,834,835,834,835,834,835,834,835,885,884,885,884,885,884,885,884,885
834,835,834,835,834,835,834,835,834,835,834,835,834,835,834,835,834,986,938,939,989,988,989,991,1041,835,834,835,834,984,985,934,934,835,834,835,834,835,1772,1772,834,835,834,835,834,835,834,835,834,835,834,835,834,835,834,835,834,835,834,835,834,835,834,835,834,835,834,835,1596,1597,1598,835,834,835,1772,1772,834,835,834,835,834,835,834,834,835,834,835,834,835,834,835,835,834,835,834,835,834,835,834,835
884,885,884,885,884,885,884,885,884,885,884,885,884,885,884,885,884,986,938,939,938,939,938,991,1091,885,884,885,884,1034,1035,984,985,885,884,885,884,885,1772,1772,884,885,884,885,884,885,884,885,884,885,884,885,884,885,884,885,884,885,884,885,884,885,884,885,884,885,884,885,1646,1647,1648,885,884,885,1772,1772,884,885,884,885,884,885,884,834,835,834,835,834,835,834,835,885,884,885,884,885,884,885,884,885
834,835,834,835,834,835,834,835,834,835,834,835,834,835,984,985,834,835,1037,1038,1038,1039,1040,1041,1041,835,834,835,834,835,834,1034,1035,835,834,835,834,835,1772,1772,834,835,834,835,834,835,834,835,834,835,834,835,834,835,834,835,834,835,834,835,834,835,834,835,834,835,834,835,834,834,834,835,834,835,1772,1772,834,835,834,835,834,835,834,834,835,834,835,834,835,834,835,835,834,835,834,835,834,835,834,835
884,885,884,885,884,885,884,885,884,885,884,885,984,985,1034,1035,884,885,835,835,835,835,835,835,884,885,884,885,884,885,884,885,884,885,884,885,884,885,1772,1772,884,885,884,885,884,885,884,885,884,885,884,885,884,885,884,885,884,885,884,885,884,885,884,885,884,885,884,885,884,885,884,885,884,885,1772,1772,884,885,884,885,884,885,884,834,835,834,835,834,835,834,835,885,884,885,884,885,884,885,884,885
834,835,834,835,834,835,834,835,834,835,834,835,1034,1035,984,985,834,835,834,835,835,835,835,835,834,835,834,835,834,835,834,835,834,835,834,835,834,835,1772,1772,1772,1772,1772,1772,1772,1772,1772,1772,1772,1772,1772,1772,1772,1772,1772,1772,1772,1772,1772,1772,1772,1772,1772,1772,1772,1772,1772,1772,1772,1772,1772,1772,1772,1772,1772,1772,834,835,834,835,834,835,834,834,835,834,835,834,835,834,835,835,834,835,834,835,834,835,834,835
884,885,884,885,884,885,884,885,884,885,884,885,884,885,1034,1035,884,885,884,885,884,885,884,885,884,885,884,885,884,885,884,885,884,885,884,885,884,885,1772,1772,1772,1772,1772,1772,1772,1772,1772,1772,1772,1772,1772,1772,1772,1772,1772,1772,1772,1772,1772,1772,1772,1772,1772,1772,1772,1772,1772,1772,1772,1772,1772,1772,1772,1772,1772,1772,884,885,884,885,884,885,884,834,835,834,835,834,835,834,835,885,884,885,884,885,884,885,884,885
834,835,834,835,834,835,834,835,834,835,834,835,834,835,834,835,834,835,834,835,834,835,834,835,834,835,834,835,834,835,834,835,834,835,834,835,834,835,834,835,834,835,834,835,834,835,834,835,834,835,834,835,834,835,834,835,834,835,834,835,834,835,834,835,834,835,834,835,834,835,834,835,834,835,834,835,834,835,834,835,834,835,834,834,835,834,835,834,835,834,835,835,834,835,834,835,834,835,834,835
884,885,884,885,884,885,884,885,884,885,884,885,884,885,884,885,884,885,884,885,884,885,884,885,884,885,884,885,884,885,884,885,884,885,884,885,884,885,884,885,884,885,884,885,884,885,884,885,884,885,884,885,884,885,884,885,884,885,884,885,884,885,884,885,884,885,884,885,884,885,884,885,884,885,884,885,884,885,884,885,884,885,884,885,884,885,884,885,884,885,884,885,884,885,884,885,884,885,884,885
834,835,834,835,834,835,834,835,834,835,834,835,834,835,834,835,834,835,834,835,834,835,834,835,834,835,834,835,834,835,834,835,834,835,834,835,834,835,834,835,834,835,834,835,834,835,834,835,834,835,834,835,834,835,834,835,834,835,834,835,834,835,834,835,834,835,834,835,834,835,834,835,834,835,834,835,834,835,834,835,834,835,834,835,834,835,834,835,834,835,834,835,834,835,834,835,834,835,834,835
884,885,884,885,884,885,884,885,884,885,884,885,884,885,884,885,884,885,884,885,884,885,884,885,884,885,884,885,884,885,884,885,884,885,884,885,884,885,884,885,884,885,884,885,884,885,884,885,884,885,884,885,884,885,884,885,884,885,884,885,884,885,884,885,884,885,884,885,884,885,884,885,884,885,884,885,884,885,884,885,884,885,884,885,884,885,884,885,884,885,884,885,884,885,884,885,884,885,884,885
