TileSet.png
100,60,16
152,300,301,350,351,55,56,57,58,105,104,108,109,153,154,155,158,159,160,202,203,210,252,253,260,302,303,304,305,308,309,310,354,355,358,359,405,406,407,408,315,316,365,366,565,566,615,616,16,89,90,139,140,189,190,239,240,436,437,486,487,536,537,586,587,540,541,542,543,544,545,590,591,592,593,594,595,645,1201,1301,1302,1351,1352,1401,1402,1563,1564,1565,1566,1567,1568,569,570,602,68
606,607,608,609,610,611,656,657,658,659,660,661,706,707,708,709,710,711,756,757,758,759,760,761,806,807,808,809,810,811,956,957,958,959,1006,1007,1008,1009,1056,1057,1058,1059,1106,1107,1108,1109,1377,1378,1379,1427,1428,1429,1477,1478,1479,122,123,124,125,172,173,174,175,222,223,224,225,272,273,274,275,1306,1307,1308,1309,1310,1311,1356,1357,1358,1359,1360,1361,1406,1407,1408,1409,1410,1411,1456,1457,1458,1459,1460,1461,1506,1507,1508,1509,1510,1511,1313,1314,1315,1316,1317,1318,1363,1364,1365,1366,1367,1368,1413,1414,1415,1416,1417,1418,1463,1464,1465,1466,1467,1468,1513,1514,1515,1516,1517,1518
3,3,95,50
7,46,91,8
152,152,152,152,152,152,152,152,152,152,152,152,152,152,152,152,152,152,152,152,152,152,152,152,152,152,152,152,152,152,152,152,152,152,152,152,152,152,152,152,152,152,152,152,152,152,152,152,152,152,152,152,152,152,152,152,152,152,152,152,152,152,152,152,152,152,152,152,152,152,152,152,152,152,152,152,152,152,152,152,152,152,152,152,152,152,152,152,152,152,152,152,152,152,152,152,152,152,152,152
152,152,152,152,152,152,152,152,152,152,152,152,152,152,152,152,152,152,152,152,152,152,152,152,152,152,152,152,152,152,152,152,152,152,152,152,152,152,152,152,152,152,152,152,152,152,152,152,152,152,152,565,566,152,152,152,152,152,152,152,152,152,152,152,152,152,152,152,152,152,152,300,301,152,152,152,152,152,152,152,152,152,152,152,152,152,152,152,152,152,152,152,152,152,152,152,152,152,152,152
152,152,152,152,152,152,152,152,152,152,152,152,152,152,152,152,152,152,152,152,152,152,152,152,152,152,152,152,152,152,152,152,152,152,152,152,152,152,152,152,152,152,152,152,152,152,152,152,152,152,152,615,616,315,316,152,152,152,152,152,152,152,152,152,152,152,152,152,152,152,152,350,351,152,152,300,301,152,152,152,152,152,152,152,152,152,152,152,152,565,566,152,152,565,566,152,152,152,152,152
152,152,300,301,152,152,152,152,152,152,152,152,152,152,152,152,152,152,152,315,316,152,152,152,152,152,152,152,152,152,152,152,152,152,152,152,152,152,152,152,152,152,152,152,152,152,152,152,152,152,565,566,152,365,366,152,152,152,152,152,300,301,152,152,152,152,152,152,152,152,152,152,152,152,152,350,351,152,152,152,152,152,152,152,300,301,152,152,152,615,616,152,152,615,616,152,152,152,152,152
152,152,350,565,566,152,152,152,152,152,152,152,152,152,152,152,152,152,152,365,366,152,152,152,152,152,152,152,152,152,152,152,152,152,152,152,152,152,152,152,152,152,152,300,301,152,152,152,152,152,615,616,152,315,316,152,152,152,152,152,350,351,565,566,152,152,152,152,152,152,152,300,301,152,152,152,152,152,152,152,152,152,152,152,350,351,152,152,152,152,152,565,566,152,152,152,152,152,152,152
152,152,152,615,616,152,152,152,152,152,152,300,301,615,152,152,152,152,152,152,152,565,566,152,152,152,152,152,152,152,152,152,152,152,152,152,152,152,152,152,152,152,152,350,351,152,152,152,565,566,152,152,300,365,366,152,152,152,152,152,152,152,615,616,152,152,152,152,152,152,152,350,351,152,152,152,152,152,152,152,152,152,152,152,152,152,152,152,152,152,152,615,616,152,152,152,152,152,152,152
152,152,152,152,152,152,152,152,152,152,152,350,351,152,152,152,152,152,152,152,152,615,616,152,152,152,152,300,301,152,152,152,152,152,152,152,152,152,152,152,152,152,152,152,152,152,152,152,615,616,152,152,350,351,152,152,152,152,152,152,152,152,152,152,152,152,152,152,152,152,152,152,152,152,152,152,152,152,152,152,152,152,152,152,152,152,152,152,152,152,152,152,152,565,566,152,152,152,152,152
152,152,152,152,152,152,152,152,152,152,152,152,152,152,152,152,565,566,152,300,301,300,301,152,152,152,152,350,351,152,152,152,152,152,152,152,152,152,152,152,152,152,152,152,152,152,152,152,152,152,152,152,152,152,152,152,152,152,152,152,152,152,152,152,152,152,152,152,68,68,68,68,68,68,68,68,68,68,68,68,68,68,68,68,68,68,68,68,152,315,316,152,152,615,616,152,152,152,152,152
152,152,152,152,300,301,152,152,152,152,152,152,152,152,152,152,615,616,55,56,57,57,57,58,152,152,152,152,152,152,152,152,152,152,152,152,152,152,152,152,152,152,152,152,152,152,152,152,152,152,152,152,152,152,152,152,152,152,152,152,152,152,152,152,152,152,152,152,68,68,1306,1307,1308,1309,1310,1311,68,68,68,68,68,68,68,68,68,68,68,68,152,365,366,315,316,152,152,152,152,152,152,152
152,152,615,152,350,351,152,152,152,152,152,152,300,301,152,152,152,152,203,206,106,206,206,358,152,152,152,152,152,152,152,152,152,152,300,301,152,152,152,152,152,152,152,152,152,152,152,152,152,152,152,300,301,152,152,152,152,152,152,152,152,152,152,152,300,301,152,152,68,68,1356,1357,1358,1359,1360,1361,68,68,68,1201,1201,1201,1201,1201,1201,1201,1201,68,152,152,152,365,366,152,300,301,152,152,152,152
152,152,152,152,152,152,152,152,152,152,152,152,350,351,152,152,152,152,203,306,307,206,206,358,152,152,152,152,152,152,152,152,152,152,350,351,152,152,152,152,152,152,152,152,152,152,152,152,152,152,301,350,351,152,351,152,152,152,152,152,152,152,152,152,350,351,152,152,68,68,1406,1407,1408,1409,1410,1411,68,68,68,68,68,68,68,68,68,68,68,68,152,152,152,152,152,152,152,152,152,152,152,152
152,152,152,152,152,152,152,152,152,152,152,152,152,152,152,152,152,152,253,356,357,206,206,358,152,152,152,152,152,152,152,152,152,152,152,152,152,152,152,152,152,152,152,152,152,152,152,152,152,55,57,57,57,57,57,58,152,152,152,152,152,152,152,152,152,152,152,152,68,68,1456,1457,1458,1459,1460,1461,68,68,68,68,866,867,868,869,870,871,68,68,152,152,152,152,565,566,152,152,152,152,152,152
152,152,152,152,152,152,152,152,152,152,152,152,152,152,152,152,152,152,405,89,90,407,407,408,152,152,152,152,152,152,152,152,152,152,152,152,152,152,152,152,152,152,152,152,152,152,152,152,152,105,575,575,575,576,207,210,152,152,152,152,152,152,152,152,152,152,152,152,68,68,1506,1507,1508,1509,1510,1511,68,68,68,68,916,917,918,919,920,921,68,68,152,152,152,152,615,616,152,152,152,152,152,152
152,152,152,152,152,152,300,301,152,152,152,152,152,152,152,152,152,152,152,139,140,351,152,152,152,152,152,152,152,152,152,152,152,152,152,152,152,152,152,152,152,152,152,152,152,152,152,152,152,203,625,625,625,626,257,210,152,300,301,152,152,152,152,152,152,152,152,152,68,68,68,68,68,68,68,68,68,68,68,68,966,967,968,969,970,971,68,68,152,152,152,152,152,152,152,152,152,152,152,152
152,152,152,152,152,152,350,351,152,152,152,152,152,152,152,152,152,152,152,189,190,152,152,152,152,152,152,152,152,152,152,152,152,152,152,152,152,152,152,152,152,152,152,152,152,152,152,152,152,203,206,206,207,206,207,210,152,350,351,152,152,152,152,152,152,152,152,152,68,68,68,68,68,68,68,68,68,68,68,68,1016,1017,1018,1019,1020,1021,68,580,152,152,152,152,152,152,152,152,152,152,152,152
152,152,152,152,152,152,152,152,565,566,152,152,152,152,152,152,152,152,152,239,240,152,152,152,152,300,301,152,152,152,152,152,152,152,152,152,565,566,152,152,152,152,152,152,152,152,152,152,152,203,206,206,257,256,257,210,152,152,152,152,152,152,300,301,152,152,152,152,68,68,68,68,68,68,68,68,68,68,68,68,68,68,68,68,68,68,68,68,152,152,152,300,301,152,152,152,152,152,152,152
152,152,152,152,152,152,152,152,615,616,152,152,152,152,152,152,152,152,152,152,152,152,152,152,152,350,351,152,152,152,152,152,152,152,152,152,615,616,152,152,152,152,152,152,152,152,152,152,152,203,207,206,207,206,207,210,152,152,152,152,152,152,350,351,152,152,152,152,68,68,1313,1314,1315,1316,1317,1318,68,68,68,1201,1201,1201,1201,1201,1201,1201,1201,68,152,152,152,350,351,152,152,152,152,152,152,152
152,152,152,152,152,152,152,152,315,316,152,152,300,301,152,152,152,152,152,152,152,152,152,152,152,152,152,152,152,152,152,152,152,122,123,124,125,122,123,124,125,152,152,152,152,152,152,152,152,203,257,256,257,256,257,210,152,152,152,152,152,152,152,152,152,152,152,152,68,68,1363,1364,1365,1366,1367,1368,68,68,68,1301,1302,1301,1302,1301,1302,68,68,68,152,152,152,152,152,152,152,152,152,152,152,152
152,152,152,152,152,152,152,152,365,366,152,152,350,351,300,152,152,152,152,152,152,152,152,152,152,152,152,152,152,152,152,152,152,172,173,174,175,172,173,174,175,152,152,152,152,152,152,152,152,203,207,206,207,206,207,210,152,152,152,152,152,152,152,152,152,152,152,152,68,68,1413,1414,1415,1416,1417,1418,68,68,68,1351,1352,1351,1352,1351,1352,1201,1201,68,152,152,152,152,152,152,152,152,152,152,152,152
152,152,152,152,300,301,152,152,152,152,152,152,152,300,301,152,152,152,152,152,152,152,152,152,152,152,152,152,152,152,152,152,152,222,223,224,225,222,223,224,225,565,566,152,152,152,152,152,152,203,257,256,257,256,257,210,300,301,152,152,152,152,152,152,152,152,152,152,68,68,1463,1464,1465,1466,1467,1468,68,68,68,1401,1402,1401,1402,1401,1402,1201,1201,68,152,152,300,301,152,152,152,152,152,152,152,152
152,152,152,152,350,351,152,152,152,152,152,152,152,350,351,152,152,152,152,152,152,152,152,152,152,152,152,152,152,152,152,565,566,272,273,274,275,272,273,274,275,615,616,152,152,152,152,152,152,203,207,206,207,206,207,210,350,351,152,152,152,152,300,301,152,152,152,152,68,68,1513,1514,1515,1516,1517,1518,68,68,68,68,68,68,68,68,68,68,68,68,152,152,350,351,152,152,152,152,152,152,152,152
152,152,152,152,152,152,152,152,152,152,152,152,152,152,152,152,152,152,152,152,152,152,152,152,152,152,152,152,152,152,152,615,616,322,323,324,325,322,323,324,325,152,152,152,152,152,152,152,152,203,257,256,257,256,257,210,152,152,152,152,152,152,350,351,152,152,152,152,68,68,1563,1564,1565,1566,1567,1568,68,68,68,68,68,68,68,68,68,68,68,68,152,152,152,152,152,152,300,301,152,152,152,152
152,152,152,152,152,152,152,152,152,152,152,152,152,152,152,152,152,152,152,152,152,152,152,152,152,152,300,301,152,152,152,152,152,152,315,316,565,566,152,152,152,152,152,152,152,152,152,152,152,203,207,206,207,206,207,210,152,152,152,152,152,152,152,152,152,152,152,152,152,300,301,152,152,152,152,152,152,152,152,152,152,152,152,152,152,152,152,152,152,152,152,152,152,152,350,351,152,152,152,152
152,152,152,152,152,152,152,152,152,152,152,152,152,152,152,152,152,152,152,152,152,152,152,152,152,152,350,351,152,152,152,152,152,152,365,366,615,616,152,152,152,152,152,152,152,152,152,152,152,203,257,256,257,256,257,158,159,160,152,152,152,152,152,152,152,152,152,152,152,350,351,152,152,152,152,152,152,300,301,152,152,152,152,152,152,152,152,152,152,152,152,152,152,152,152,152,152,152,152,152
152,152,152,152,152,152,152,152,152,152,152,152,152,152,152,152,152,152,152,152,152,152,152,152,152,152,152,152,152,152,152,152,152,152,152,152,152,152,152,152,152,152,152,152,152,152,152,152,152,203,207,206,207,206,207,206,206,260,152,152,152,152,152,152,152,152,152,152,152,152,152,152,152,152,152,152,152,350,351,152,152,152,152,152,152,152,152,152,152,152,152,152,152,152,152,152,152,152,152,152
152,152,300,301,152,152,152,152,152,152,152,152,300,301,152,152,152,152,152,152,152,152,152,152,152,152,152,152,152,152,152,152,152,152,152,152,152,152,152,152,152,152,152,152,152,152,152,152,152,203,257,256,257,256,257,256,206,260,152,152,152,152,152,152,152,152,152,152,152,152,152,152,152,152,152,152,152,152,152,152,152,152,300,301,152,152,152,152,152,152,300,301,152,152,152,152,152,152,152,152
152,152,350,351,152,152,152,152,152,152,152,152,350,351,152,152,152,152,152,152,152,152,152,152,152,152,152,152,152,152,152,152,152,152,152,152,152,152,152,152,152,152,152,152,152,152,152,152,55,155,207,206,207,206,207,206,206,260,152,152,152,152,152,152,152,152,152,152,152,152,152,152,152,152,152,152,152,152,152,152,152,152,350,351,152,152,152,152,152,152,350,351,152,152,152,152,152,152,152,152
152,152,152,152,152,152,152,152,152,152,152,152,152,152,152,152,152,152,152,152,152,152,152,152,152,152,152,152,152,152,152,152,152,152,152,55,56,56,56,56,56,56,56,56,56,56,56,56,155,207,206,207,206,207,206,207,206,158,57,57,57,57,57,57,57,57,57,57,57,57,57,57,57,58,152,152,152,152,152,152,152,152,152,152,152,152,152,152,152,152,152,152,152,152,152,152,152,152,152,152
152,152,152,152,152,153,56,56,56,56,56,56,56,56,56,56,56,56,56,56,56,56,56,56,56,56,436,437,436,437,56,56,56,56,56,155,256,257,256,257,256,257,256,257,256,257,256,257,256,257,825,826,827,828,829,830,256,257,256,257,256,257,256,257,256,257,256,257,256,257,256,257,256,158,57,57,57,57,57,57,57,57,57,57,57,57,57,57,57,57,57,57,57,436,437,436,437,57,57,57
56,56,56,56,56,155,206,207,206,207,206,207,206,207,206,207,206,207,206,207,206,207,206,207,206,207,486,487,486,487,206,207,206,207,206,207,206,207,206,207,206,207,206,207,206,207,206,207,206,207,875,876,877,878,879,880,206,207,206,207,206,207,206,207,206,207,206,207,206,207,206,207,206,207,206,207,206,207,206,207,206,207,206,207,206,207,206,207,206,207,206,575,576,486,487,486,487,625,206,207
256,257,256,257,256,257,256,257,256,257,256,257,256,257,256,257,256,257,256,257,256,257,256,257,256,257,536,537,536,537,256,257,256,257,256,257,256,257,256,257,256,257,256,257,256,257,256,257,256,257,925,926,927,928,929,930,256,257,256,257,256,257,256,257,256,257,256,257,256,257,256,257,256,257,256,206,206,206,206,206,206,206,206,206,206,206,206,206,206,206,206,625,626,536,537,536,537,257,256,257
206,207,206,207,206,207,206,207,206,207,206,207,206,207,206,207,206,207,206,207,206,207,206,207,308,406,586,587,586,587,406,406,406,406,406,406,406,406,406,406,406,406,406,406,406,406,407,305,206,207,975,976,977,978,979,980,206,207,206,207,206,207,206,207,206,207,206,207,206,207,206,207,206,207,206,206,206,206,206,206,206,206,206,206,206,206,206,206,206,206,206,206,308,586,587,586,587,89,90,407
256,257,256,257,256,257,256,257,256,257,256,257,256,257,256,257,256,257,256,257,256,257,256,257,260,152,152,602,602,152,152,152,152,152,152,152,152,152,152,152,152,152,152,152,152,152,152,203,256,257,1025,1026,1027,1028,1029,1030,256,257,308,407,407,407,407,407,407,407,407,407,407,407,407,407,407,407,407,407,407,407,407,407,407,407,407,407,407,407,407,407,407,407,407,407,408,152,152,152,152,139,140,152
206,206,308,406,406,406,406,406,406,406,406,406,406,406,406,406,406,406,406,406,406,406,406,406,408,152,152,602,602,152,152,152,152,152,152,152,152,152,152,152,152,152,152,152,152,152,152,303,305,256,1075,1076,1077,1078,1079,1080,205,205,210,152,152,152,152,152,152,152,152,152,152,152,152,152,152,152,152,152,152,152,152,152,152,152,152,152,152,152,152,152,152,152,152,152,152,152,152,152,152,189,190,152
206,206,260,152,152,152,152,152,152,152,152,152,152,152,152,152,152,152,152,152,152,152,152,152,152,152,152,602,602,152,152,152,152,152,152,152,152,152,152,152,152,152,152,152,152,152,152,152,203,206,207,206,207,206,207,206,308,407,408,152,152,152,152,152,152,152,152,152,152,152,152,152,152,152,152,152,152,152,152,152,152,152,152,152,152,152,152,152,152,152,152,152,152,152,152,152,152,239,240,152
407,407,408,152,152,152,152,152,152,152,152,152,152,152,152,152,300,301,152,152,152,152,152,152,152,152,152,602,602,152,152,152,152,300,301,152,152,152,152,152,152,300,301,152,152,152,152,152,203,256,257,256,257,256,257,256,260,152,152,152,152,152,152,152,152,152,152,152,152,152,152,152,152,152,152,152,152,152,152,152,152,152,152,152,152,152,152,152,152,152,152,152,565,566,152,152,300,301,152,152
152,152,152,152,152,152,152,152,152,152,152,152,152,152,152,152,350,351,152,152,152,152,152,152,152,152,152,602,602,152,152,152,152,350,351,152,152,152,152,152,152,350,351,152,152,152,152,152,405,304,304,305,207,206,207,206,260,152,152,152,152,152,152,152,152,152,152,152,152,152,152,152,152,152,152,152,565,566,152,152,152,152,152,152,152,152,152,152,152,152,152,152,615,616,152,152,350,351,152,152
152,152,152,152,152,152,152,152,152,152,152,152,152,152,152,152,152,152,152,152,152,152,152,152,152,152,152,602,602,152,152,152,152,152,152,152,152,152,152,152,152,152,152,152,152,152,152,152,152,152,152,203,257,256,256,256,260,152,152,152,152,300,301,152,152,152,152,152,152,152,152,300,301,152,152,152,615,616,152,152,152,152,152,152,152,152,152,152,152,300,301,152,152,565,566,565,350,351,152,152
152,152,152,152,152,152,152,152,152,602,602,602,602,602,602,602,602,602,602,602,602,602,602,602,602,602,602,602,602,152,152,152,152,152,152,152,152,152,152,152,152,152,152,152,152,152,152,152,152,152,152,203,207,206,256,256,260,152,152,152,152,350,351,152,565,315,316,152,152,152,152,350,351,152,152,152,152,152,152,152,152,152,152,152,152,152,152,152,152,350,351,152,152,615,616,615,616,152,152,152
152,152,152,152,315,316,152,152,152,602,602,606,607,608,609,610,611,602,602,602,602,606,607,608,609,610,611,602,602,152,152,152,152,152,152,152,152,152,152,152,152,152,152,152,152,152,152,152,152,152,152,203,257,256,256,256,260,152,152,152,152,152,152,152,615,365,366,152,152,152,152,152,152,152,152,152,152,152,152,152,152,152,152,152,152,152,152,152,152,152,152,152,152,152,300,301,152,152,152,152
152,152,152,152,365,366,152,152,152,602,602,656,657,658,659,660,661,956,957,958,959,656,657,658,659,660,661,602,602,152,152,152,152,152,152,152,152,152,152,152,152,152,152,152,152,152,152,152,152,152,152,203,207,206,256,256,260,152,152,152,152,152,152,152,152,152,152,152,152,152,152,152,152,152,152,152,152,152,152,152,152,152,152,152,300,301,152,152,152,152,152,152,152,152,350,351,152,152,152,152
152,152,300,301,152,152,152,152,152,602,602,706,707,708,709,710,711,1006,1007,1008,1009,706,707,708,709,710,711,602,602,152,152,152,152,152,152,152,152,152,152,152,152,152,152,152,152,152,152,152,152,152,152,540,541,542,543,544,545,152,152,152,152,152,152,152,152,152,152,152,152,122,123,124,125,122,123,124,125,152,152,152,152,152,152,152,350,351,152,152,152,152,152,300,301,152,152,152,152,152,152,152
152,152,350,351,152,152,565,566,152,602,602,756,757,758,759,760,761,1056,1057,1058,1059,756,757,758,759,760,761,602,602,602,602,602,602,602,602,602,602,602,602,602,602,602,602,602,602,602,602,602,602,602,602,590,591,592,593,594,595,152,152,152,152,152,152,152,152,152,152,152,152,172,173,174,175,172,173,174,175,152,152,152,152,152,152,152,152,152,152,152,152,152,152,350,351,152,152,152,152,152,152,152
152,152,152,152,152,152,615,616,152,602,602,806,807,808,809,810,811,1106,1107,1108,1109,806,807,808,809,810,811,602,602,602,602,602,602,602,602,602,602,602,602,602,602,602,602,602,602,602,602,602,602,602,602,640,641,642,643,644,645,152,152,152,152,152,152,300,301,152,152,152,152,222,223,224,225,222,223,224,225,122,123,124,125,152,152,152,152,152,152,152,152,152,152,152,152,152,152,152,152,152,152,152
152,152,152,152,152,152,565,566,152,602,602,602,602,602,602,602,602,602,602,602,602,602,602,602,602,602,602,602,602,152,152,152,152,152,152,152,152,152,152,152,152,152,152,152,152,152,152,152,152,152,152,203,207,206,207,206,260,152,152,152,152,152,152,350,351,152,152,152,152,272,273,274,275,272,273,274,275,172,173,174,175,152,152,152,152,152,152,152,152,152,315,316,152,152,152,152,152,152,152,152
152,152,152,152,152,152,615,616,152,602,602,602,602,602,602,602,602,602,602,602,602,602,602,602,602,602,602,602,602,152,152,152,152,152,152,152,152,152,152,152,152,152,152,152,152,152,152,152,152,152,152,203,257,256,257,256,260,152,152,152,152,152,152,152,152,152,152,152,152,322,323,324,325,322,323,324,325,222,223,224,225,152,152,152,152,152,152,152,152,152,365,366,152,152,152,152,152,152,152,152
152,152,152,152,152,152,152,152,152,602,602,602,602,602,602,602,602,602,602,602,602,602,602,602,602,602,602,602,602,152,152,152,152,152,152,152,152,152,152,152,152,152,152,152,152,152,152,152,152,152,152,203,207,206,308,407,408,152,152,152,152,152,152,152,152,152,152,152,152,122,123,124,125,122,123,124,125,272,273,274,275,152,152,152,152,152,152,152,152,152,152,152,152,152,152,152,152,152,152,152
152,152,152,152,152,152,152,152,152,602,602,602,602,602,602,602,602,602,602,602,602,602,602,602,602,602,602,602,602,152,152,152,152,152,152,152,152,152,300,301,152,152,152,152,152,152,152,152,152,152,152,203,257,256,210,152,152,152,152,152,152,152,152,152,152,152,152,152,152,172,173,174,175,172,173,174,175,322,323,324,325,152,152,152,152,152,152,152,152,152,152,152,152,152,152,152,152,152,152,152
152,152,152,152,152,152,152,152,152,602,602,602,602,602,602,602,602,602,1377,1378,1379,602,602,602,602,602,602,602,602,152,152,152,152,565,566,152,152,152,350,351,152,152,152,152,152,152,152,152,152,152,152,203,207,206,210,152,152,152,152,152,152,152,152,152,152,152,152,152,152,222,223,224,225,222,223,224,225,152,152,152,152,152,152,152,152,152,152,152,152,152,152,152,152,152,152,152,152,152,152,152
152,152,152,152,152,152,152,152,152,602,602,602,602,602,602,602,602,602,1427,1428,1429,602,602,602,602,602,602,602,602,152,152,152,152,615,616,152,152,152,152,152,152,152,152,152,152,152,152,152,152,152,152,203,257,256,210,152,152,152,152,152,152,152,152,152,152,300,301,152,152,272,273,274,275,272,273,274,275,152,152,152,565,566,152,152,152,152,152,152,152,152,152,152,152,152,152,152,152,152,152,152
152,152,152,152,152,300,301,152,152,602,602,602,602,602,602,602,602,602,1477,1478,1479,602,602,602,602,602,602,602,602,152,152,152,152,152,152,152,152,122,123,124,125,152,152,152,152,152,152,152,152,152,152,203,207,206,210,152,152,300,301,152,152,152,152,152,152,350,351,152,152,322,323,324,325,322,323,324,325,152,152,152,615,616,152,152,152,152,152,152,152,152,152,152,152,152,152,152,152,152,152,152
152,152,152,152,152,350,351,152,152,602,602,602,602,602,602,602,602,602,602,602,602,602,602,602,602,602,602,602,602,152,152,152,152,152,152,152,152,172,173,174,175,152,152,152,152,152,152,152,152,152,152,203,257,256,210,152,152,350,351,152,152,152,152,152,152,152,152,565,566,152,152,152,152,152,152,152,152,565,566,152,152,152,152,152,152,152,152,152,152,152,152,152,152,152,152,152,152,152,152,152
152,152,152,152,152,152,152,152,152,570,602,602,602,602,602,602,602,602,602,602,602,602,602,602,602,602,602,602,570,152,152,152,152,152,565,566,152,222,223,224,225,152,152,152,152,152,152,152,152,152,152,203,207,206,210,152,152,152,152,152,152,152,152,152,152,152,152,615,616,152,152,152,152,152,565,566,152,615,616,152,152,152,152,152,152,152,152,152,152,152,152,152,152,152,152,152,152,152,152,152
152,152,152,152,152,152,152,152,152,570,569,602,602,602,602,602,602,602,602,602,602,602,602,602,602,602,602,569,570,152,152,152,152,152,615,616,152,272,273,274,275,152,152,152,565,566,152,152,152,152,152,203,257,256,210,152,152,152,152,152,152,152,152,152,152,152,152,152,152,152,152,152,300,301,615,616,152,152,152,152,152,152,152,152,152,300,301,152,152,300,301,152,152,152,565,566,152,152,152,152
152,152,300,301,152,152,152,152,152,570,569,569,602,602,602,602,602,602,602,602,602,602,602,602,602,602,569,569,570,152,152,152,152,152,152,152,152,322,323,324,325,152,152,152,615,616,152,152,152,152,152,203,207,206,210,152,152,152,152,152,152,152,152,152,152,152,152,152,152,152,152,152,350,351,152,152,152,152,152,152,152,152,152,152,152,350,351,152,152,350,351,152,152,152,615,616,152,152,152,152
152,152,350,351,152,152,152,152,300,570,570,570,570,570,602,602,602,602,602,602,602,602,602,602,570,570,570,570,570,152,152,152,152,152,152,152,565,566,152,152,152,315,316,152,152,152,152,152,152,152,152,203,257,256,210,152,152,152,152,152,152,152,152,152,152,152,152,152,152,152,152,152,152,152,152,152,152,152,152,152,152,152,152,152,152,152,152,152,152,152,152,152,565,566,315,316,152,152,152,152
152,152,152,152,152,152,152,152,350,351,152,152,152,152,152,152,152,152,152,152,152,152,152,152,152,152,152,152,152,152,152,152,152,152,152,152,615,616,152,152,152,365,366,152,152,152,152,152,152,152,152,203,207,206,210,152,152,300,301,152,152,152,152,300,301,152,152,152,152,152,152,152,152,152,152,152,152,152,152,152,152,152,152,152,152,152,152,152,152,152,152,152,615,616,365,366,152,152,152,152
152,152,152,152,152,152,152,152,152,152,152,152,152,152,152,152,152,152,152,152,152,152,152,152,152,152,152,152,152,152,152,152,152,152,152,152,152,152,152,152,152,300,301,152,152,152,152,152,152,152,152,203,206,207,210,152,152,350,351,152,152,152,152,350,351,152,152,152,152,152,152,152,300,301,152,152,152,152,152,152,152,152,152,152,152,615,152,152,152,152,152,152,152,152,152,152,152,152,152,152
152,152,152,152,152,152,152,152,152,152,152,152,152,152,152,152,152,152,152,152,152,152,152,152,152,152,152,152,152,152,152,152,152,152,152,152,152,152,152,152,152,350,351,152,152,152,152,152,152,152,152,203,256,257,210,152,152,152,152,152,152,152,152,152,152,152,152,152,152,152,152,152,350,351,152,152,152,152,152,152,152,152,152,152,152,152,152,152,152,152,152,152,152,152,152,152,152,152,152,152
152,152,152,152,152,152,152,152,152,152,152,152,152,152,152,152,152,152,152,152,152,152,152,152,152,152,152,152,152,152,152,152,152,152,152,152,152,152,152,152,152,152,152,152,152,152,152,152,152,152,152,203,257,256,210,152,152,152,152,152,152,152,152,152,152,152,152,152,152,152,152,152,152,152,152,152,152,152,152,152,152,152,152,152,152,152,152,152,152,152,152,152,152,152,152,152,152,152,152,152
